111111111111111111111111111111111111111111111111111111111111111
1.............................................................1
1.............................................................1
1.............................................................1
1.............................................................1
1.......11111......11111......................................1
1.......1..............1......................................1
1.......1..............1......................................1
1.......1..............1......................................1
1.......1..............1......................................1
1.............................................................1
1..............11.............................................1
1..............11.............................................1
1.............................................................1
1.......1..............1......................................1
1.......1..............1......................................1
1.......1..............1......................................1
1.......1..............1......................................1
1.......1111111111111111......................................1
1.............................................................1
1.............................................................1
1.............................................................1
1.............................................................1
1.............................................................1
1.............................................................1
1.............................................................1
1.............................................................1
1.............................................................1
1.............................................................1
1.............................................................1
1.............................................................1
1................................................Z............1
1.............................................................1
1.............................1111BB111111111111BB1111111111..1
1.............................1............................1..1
1.............................1........Z...................1..1
1.............................1..................P.........1..1
1.............................1............................1..1
1.............................B.........Z...Z..............1..1
1.............................B............................1..1
1..........................1111............................1..1
1..........................1...............................1..1
1..........................1...............................1..1
1..........................111111111BB111111111111BB11111111..1
1.............................................................1
1.............................................................1
111111111111111111111111111111111111111111111111111111111111111